112,106,100,96,100,106,112,118
106,100,94,88,94,100,106,112
100,94,86,80,86,94,100,106
94,88,80,72,80,88,94,100
88,82,74,66,74,82,88,94
82,76,68,60,68,76,82,88
78,72,64,55,64,72,78,84
82,76,68,60,68,76,82,88
