90,84,78,72,66,62,60,62
96,88,80,72,65,60,55,60
100,92,84,75,67,61,58,62
108,100,90,80,72,66,63,66
118,110,100,90,80,73,70,72
128,120,110,100,90,82,78,80
138,130,120,110,100,91,86,88
146,138,128,118,108,100,94,96
