62,60,62,66,72,78,84,90
60,55,60,65,72,80,88,96
62,58,61,67,75,84,92,100
66,63,66,72,80,90,100,108
72,70,73,80,90,100,110,118
80,78,82,90,100,110,120,128
88,86,91,100,110,120,130,138
96,94,100,108,118,128,138,146
